wwwwwwwwwwwwwwwwwwwwwwww
w......................w
w......................w
w......................w
w......................w
w.....w................w
w.....w................w
w.....w................w
w.....w................w
w.....w................w
w.....w................w
w.....wwwwwwwwwwwwwwwwww
w......................w
w......................w
w......................w
w......................w
w.....wwwww............w
w.....w...w............w
w.....w...w............w
w.....w...w............w
w.....www.w............w
w......................w
w......................w
w......................w
wwwwwwwwwwwwwwwwwwwwwwww