wwwwwwwwwwwwwwwwwwwwwwww
w......................w
w......................w
w......................w
w................A.....w
w......................w
w......................w
w......................w
w........wwwwwwwwwwwwwww
w......................w
w......................w
w........0.............w
w......................w
w......................w
w........wwwwwwwwwwwwwww
w......................w
w......................w
w......................w
w......................w
w......................w
w................X.....w
w......................w
w......................w
w......................w
wwwwwwwwwwwwwwwwwwwwwwww