wwwwwwwwwwwwwwwwwwwwwwww
w...............w......w
w...............w......w
w...............w......w
w...............w.A....w
w...............w......w
w...............w......w
w...............w......w
w......................w
w......................w
w......................w
w.....wwwwwwwwwwwwwwwwww
w......................w
w......................w
w...............0......w
w......................w
w.....wwwwww...........w
w.....w................w
w.....w.............X..w
w.....w................w
w.....w................w
w......................w
w......................w
w......................w
wwwwwwwwwwwwwwwwwwwwwwww