wwwwwwwwwwwwwwwwwwwwwwww
w...............w......w
w...............w......w
w...............w......w
w...............w......w
w...............w......w
w...............w......w
w...............w......w
w......................w
w...........wwwwwwwwwwww
w...........w..........w
w...........w..........w
w...........w..........w
w...........w..........w
wwwwwwwww.wwwwww.....www
w......................w
w......................w
w......................w
w......................w
w......................w
w......................w
w......................w
w......................w
w......................w
wwwwwwwwwwwwwwwwwwwwwwww